11111111111
1PEC0000001
100001010C1
11111111111