111111111111111111111111111
1PEC00000000000N00000000001
100C00000C000C0000C010000C1
100000010C0000C00001000C001
100001010C00000C00000C00001
111111111111111111111111111